# $Id$
#
# Edit this file after adding a new GMT module and run gmt_make_module_src.sh
# to generate gmt_module.h and gmt_module.c.
#
backtracker	spotter	k_mode_gmt	Generate forward and backward flowlines and hotspot tracks
blockmean	core	k_mode_gmt	Block average (x,y,z) data tables by L2 norm
blockmedian	core	k_mode_gmt	Block average (x,y,z) data tables by L1 norm (spatial median)
blockmode	core	k_mode_gmt	Block average (x,y,z) data tables by mode estimation
colmath	core	k_mode_gmt	Do mathematics on columns from data tables
filter1d	core	k_mode_gmt	Do time domain filtering of 1-D data tables
fitcircle	core	k_mode_gmt	Find mean position and best-fitting great- or small-circle to points on sphere
gmt2kml	core	k_mode_gmt	Convert GMT data tables to KML files for Google Earth
gmtaverage	core	k_mode_gmt	Block average (x,y,z) data tables by mean, median, or mode estimation
gmtconvert	core	k_mode_gmt	Convert, paste, or extract columns from data tables
gmtdefaults	core	k_mode_psl	List current GMT default parameters
gmtdp	core	k_mode_gmt	Line reduction using the Douglas-Peucker algorithm
gmtget	core	k_mode_psl	Get individual GMT default parameters
gmtmath	core	k_mode_gmt	Reverse Polish Notation (RPN) calculator for data tables
gmtselect	core	k_mode_gmt	Select data table subsets based on multiple spatial criteria
gmtset	core	k_mode_psl	Change individual GMT default parameters
gmtspatial	core	k_mode_gmt	Do geospatial operations on lines and polygons
gmtstitch	core	k_mode_gmt	Join individual lines whose end points match within tolerance
gmtvector	core	k_mode_gmt	Basic manipulation of Cartesian vectors
gmtwhich	core	k_mode_gmt	Find full path to specified files
gravfft	potential	k_mode_gmt	Compute gravitational attraction of 3-D surfaces and a little more (ATTENTION z positive up)
grd2cpt	core	k_mode_gmt	Make linear or histogram-equalized color palette table from grid
grd2rgb	core	k_mode_gmt	Write r/g/b grid files from a grid file, a raw RGB file, or SUN rasterfile
grd2xyz	core	k_mode_gmt	Convert grid file to data table
grdblend	core	k_mode_gmt	Blend several partially over-lapping grids into one larger grid
grdclip	core	k_mode_gmt	Clip the range of grids
grdcontour	core	k_mode_psl	Make contour map using a grid
grdcut	core	k_mode_gmt	Extract subregion from a grid
grdedit	core	k_mode_gmt	Modify header or content of a grid
grdfft	core	k_mode_gmt	Do mathematical operations on grids in the wavenumber (or frequency) domain
grdfilter	core	k_mode_gmt	Filter a grid in the space (or time) domain
grdgradient	core	k_mode_gmt	Compute directional gradients from a grid
grdhisteq	core	k_mode_gmt	Perform histogram equalization for a grid
grdimage	core	k_mode_psl	Project grids or images and plot them on maps
grdinfo	core	k_mode_gmt	Extract information from grids
grdlandmask	core	k_mode_gmt	Create a \"wet-dry\" mask grid from shoreline data base
grdmask	core	k_mode_gmt	Create mask grid from polygons or point coverage
grdmath	core	k_mode_gmt	Reverse Polish Notation (RPN) calculator for grids (element by element)
grdokb	potential	k_mode_gmt	Computes the gravity effect of one (or two) grids by the method of Okabe
grdpaste	core	k_mode_gmt	Join two grids along their common edge
grdpmodeler	spotter	k_mode_gmt	Evaluate a plate model on a geographic grid
grdproject	core	k_mode_gmt	Forward and inverse map transformation of grids
grdraster	dbase	k_mode_gmt	Extract subregion from a binary raster and save as a GMT grid
grdreformat	core	k_mode_gmt	Convert between different grid formats
grdrotater	spotter	k_mode_gmt	Finite rotation reconstruction of geographic grid
grdsample	core	k_mode_gmt	Resample a grid onto a new lattice
grdspotter	spotter	k_mode_gmt	Create CVA image from a gravity or topography grid
grdtrack	core	k_mode_gmt	Sample grids at specified (x,y) locations
grdtrend	core	k_mode_gmt	Fit trend surface to grids and compute residuals
grdvector	core	k_mode_psl	Plot vector field from two component grids
grdview	core	k_mode_psl	Create 3-D perspective image or surface mesh from a grid
grdvolume	core	k_mode_gmt	Calculate grid volume and area constrained by a contour
greenspline	core	k_mode_gmt	Interpolate using Green's functions for splines in 1-3 dimensions
gshhg	gshhg	k_mode_gmt	Extract data tables from binary GSHHS or WDBII data files
hotspotter	spotter	k_mode_gmt	Create CVA image from seamount locations
img2grd	imgsrc	k_mode_gmt	Extract a subset from an img file in Mercator or Geographic format
kml2gmt	core	k_mode_gmt	Extract GMT table data from Google Earth KML files
makecpt	core	k_mode_gmt	Make GMT color palette tables
mapproject	core	k_mode_gmt	Do forward and inverse map transformations, datum conversions and geodesy
mgd77convert	mgd77	k_mode_gmt	Convert MGD77 data to other file formats
mgd77info	mgd77	k_mode_gmt	Extract information about MGD77 files
mgd77list	mgd77	k_mode_gmt	Extract data from MGD77 files
mgd77magref	mgd77	k_mode_gmt	Evaluate the IGRF or CM4 magnetic field models
mgd77manage	mgd77	k_mode_gmt	Manage the content of MGD77+ files
mgd77path	mgd77	k_mode_gmt	Return paths to MGD77 cruises and directories
mgd77sniffer	mgd77	k_mode_gmt	Along-track quality control of MGD77 cruises
mgd77track	mgd77	k_mode_psl	Plot track-line map of MGD77 cruises
minmax	core	k_mode_gmt	Find extreme values in data tables
nearneighbor	core	k_mode_gmt	Grid table data using a \"Nearest neighbor\" algorithm
originator	spotter	k_mode_gmt	Associate seamounts with nearest hotspot point sources
project	core	k_mode_gmt	Project table data onto lines or great circles, generate tracks, or translate coordinates
ps2raster	core	k_mode_gmt	Convert [E]PS file(s) to other formats using GhostScript.
psbasemap	core	k_mode_psl	Plot PostScript base maps
psclip	core	k_mode_psl	Initialize or terminate polygonal clip paths
pscoast	core	k_mode_psl	Plot continents, shorelines, rivers, and borders on maps
pscontour	core	k_mode_psl	Contour table data by direct triangulation
pscoupe	meca	k_mode_psl	Plot cross-sections of focal mechanisms
pshistogram	core	k_mode_psl	Calculate and plot histograms
psimage	core	k_mode_psl	Place images or EPS files on maps
pslegend	core	k_mode_psl	Plot legends on maps
psmask	core	k_mode_psl	Use data tables to clip or mask map areas with no coverage
psmeca	meca	k_mode_psl	Plot focal mechanisms on maps
pspolar	meca	k_mode_psl	Plot polarities on the inferior focal half-sphere on maps
psrose	core	k_mode_psl	Plot a polar histogram (rose, sector, windrose diagrams)
psscale	core	k_mode_psl	Plot a gray-scale or color-scale on maps
pssegy	segy	k_mode_psl	Plot a SEGY file on a map
pssegyz	segy	k_mode_psl	Plot a SEGY file in PostScript
pstext	core	k_mode_psl	Plot or typeset text on maps
psvelo	meca	k_mode_psl	Plot velocity vectors, crosses, and wedges on maps
pswiggle	core	k_mode_psl	Plot z = f(x,y) anomalies along tracks
psxy	core	k_mode_psl	Plot lines, polygons, and symbols on maps
psxyz	core	k_mode_psl	Plot lines, polygons, and symbols in 3-D
redpol	potential	k_mode_gmt	Compute the Continuous Reduction To the Pole, AKA differential RTP
rotconverter	spotter	k_mode_gmt	Manipulate total reconstruction and stage rotations
sample1d	core	k_mode_gmt	Resample 1-D table data using splines
segy2grd	segy	k_mode_gmt	Converting SEGY data to a GMT grid
spectrum1d	core	k_mode_gmt	Compute auto- [and cross-] spectra from one [or two] timeseries
sphdistance	sph	k_mode_gmt	Make grid of distances to nearest points on a sphere
sphinterpolate	sph	k_mode_gmt	Spherical gridding in tension of data on a sphere
sphtriangulate	sph	k_mode_gmt	Delaunay or Voronoi construction of spherical lon,lat data
splitxyz	core	k_mode_gmt	Split xyz[dh] data tables into individual segments
surface	core	k_mode_gmt	Grid table data using adjustable tension continuous curvature splines
testapi	core	k_mode_psl	test API i/o methods for any data type
trend1d	core	k_mode_gmt	Fit a [weighted] [robust] polynomial [or Fourier] model for y = f(x) to xy[w] data
trend2d	core	k_mode_gmt	Fit a [weighted] [robust] polynomial for z = f(x,y) to xyz[w] data
triangulate	core	k_mode_gmt	Do optimal (Delaunay) triangulation and gridding of Cartesian table data
x2sys_binlist	x2sys	k_mode_gmt	Create bin index listing from track data files
x2sys_cross	x2sys	k_mode_gmt	Calculate crossovers between track data files
x2sys_datalist	x2sys	k_mode_gmt	Extract content of track data files
x2sys_get	x2sys	k_mode_gmt	Get track listing from track index database
x2sys_init	x2sys	k_mode_gmt	Initialize a new x2sys track database
x2sys_list	x2sys	k_mode_gmt	Extract subset from crossover data base
x2sys_merge	x2sys	k_mode_gmt	Merge an updated COEs table (smaller) into the main table (bigger)
x2sys_put	x2sys	k_mode_gmt	Update track index database from track bin file
x2sys_report	x2sys	k_mode_gmt	Report statistics from crossover data base
x2sys_solve	x2sys	k_mode_gmt	Determine least-squares systematic correction from crossovers
xyz2grd	core	k_mode_gmt	Convert data table to a grid file
xyzokb	potential	k_mode_gmt	Compute the gravity/magnetic anomaly of a body by the method of Okabe
